15 29
#############################
# # # # # # # # # # # # # # #
### ### ### ### ### ### ### #
#                           #
# # # # # # # # # # # # # # #
# # # # # # # # # # # # # # #
#                           #
### ## ## ## ##*## ## ## ## #
#                           #
# # # # # # # # # # # # # # #
# # # # # # # # # # # # # # #
#                           #
# ### ### ### # # ### ### ###
# # # # # # # # # # # # # # #
###############$#############