20 45
#############################################
#                                           #
#                                           #
#                                           #
#                                           #
#                                           #
#                                           #
#                #########                  #
#                #       #                  #
#                    *   #                  #
#                #       #                  #
#                #########                  #
#                                           #
#                                           #
#                                           #
#                                           #
#                                           $
#                                           #
#                                           #
#############################################